GRID:
13,13
1,1,1,1,1,1,1,1,1,1,1,1,1
1,0,0,1,0,0,1,0,0,0,1,0,1
1,0,0,1,0,0,2,0,1,0,2,0,1
1,1,3,1,1,0,1,0,2,0,1,0,1
1,1,0,0,1,3,1,0,1,0,2,0,1
1,1,1,0,0,0,1,0,2,0,1,0,1
1,0,1,1,0,0,2,0,1,0,1,0,1
1,0,0,1,3,1,1,3,1,0,1,3,1
1,0,0,0,0,1,0,0,1,0,1,0,1
1,0,0,0,0,1,0,0,1,0,1,0,1
1,3,1,1,1,1,0,0,1,0,2,0,1
1,0,0,0,0,1,0,0,2,0,1,0,1
1,1,1,1,1,1,1,1,1,1,1,1,1

START:
1,1

END:
3,11

BADGUYS:
6
4,5
1,8
2,8
1,11
11,1
11,11