GRID:
10,10
1,1,1,1,1,1,1,1,1,1
1,0,0,0,1,0,0,0,0,1
1,0,0,0,1,0,0,0,0,1
1,0,0,0,2,0,0,0,0,1
1,1,3,1,1,1,0,0,0,1
1,0,0,1,0,1,0,0,0,1
1,1,1,1,3,1,0,0,0,1
1,0,0,0,0,0,0,0,0,1
1,0,0,0,0,0,0,0,0,1
1,1,1,1,1,1,1,1,1,1

START:
1,1

END:
4,5

BADGUYS:
2
5,1
8,7